EA ./texture/EAST.png
WE ./texture/WEST.png
SO ./texture/SOUTH.png
NO ./texture/NORTH.png
F 10,225,11
C 225,10,2

11111
10001
10N01
100 1
11111
