EA ./texture/EAST.png
WE ./texture/WEST.png
SO ./texture/SOUTH.png
NO ./texture/NORTH.png
C 125,79,69
F 27,135,209

11111
10001
10N01
10001
11111
